------ ------
|           |
|           |
|           |
-------------
