------ ------
|...........|
|...........|
|...........|
-------------
